TGT.T	ACA.A
GGT.T	ACC.A
CGT.T	ACG.A
AGT.T	ACT.A
TGG.T	CCA.A
GGG.T	CCC.A
CGG.T	CCG.A
CCT.A	CCT.A
TGC.T	GCA.A
GGC.T	GCC.A
GCG.A	GCG.A
GCT.A	GCT.A
TGA.T	TCA.A
TCC.A	TCC.A
TCG.A	TCG.A
TCT.A	TCT.A
TGT.C	ACA.G
GGT.C	ACC.G
CGT.C	ACG.G
AGT.C	ACT.G
TGG.C	CCA.G
GGG.C	CCC.G
CGG.C	CCG.G
CCT.G	CCT.G
TGC.C	GCA.G
GGC.C	GCC.G
GCG.G	GCG.G
GCT.G	GCT.G
TGA.C	TCA.G
TCC.G	TCC.G
TCG.G	TCG.G
TCT.G	TCT.G
TGT.A	ACA.T
GGT.A	ACC.T
CGT.A	ACG.T
AGT.A	ACT.T
TGG.A	CCA.T
GGG.A	CCC.T
CGG.A	CCG.T
CCT.T	CCT.T
TGC.A	GCA.T
GGC.A	GCC.T
GCG.T	GCG.T
GCT.T	GCT.T
TGA.A	TCA.T
TCC.T	TCC.T
TCG.T	TCG.T
TCT.T	TCT.T
TAT.T	ATA.A
GAT.T	ATC.A
CAT.T	ATG.A
ATT.A	ATT.A
TAG.T	CTA.A
GAG.T	CTC.A
CTG.A	CTG.A
CTT.A	CTT.A
TAC.T	GTA.A
GTC.A	GTC.A
GTG.A	GTG.A
GTT.A	GTT.A
TTA.A	TTA.A
TTC.A	TTC.A
TTG.A	TTG.A
TTT.A	TTT.A
TAT.G	ATA.C
GAT.G	ATC.C
CAT.G	ATG.C
ATT.C	ATT.C
TAG.G	CTA.C
GAG.G	CTC.C
CTG.C	CTG.C
CTT.C	CTT.C
TAC.G	GTA.C
GTC.C	GTC.C
GTG.C	GTG.C
GTT.C	GTT.C
TTA.C	TTA.C
TTC.C	TTC.C
TTG.C	TTG.C
TTT.C	TTT.C
TAT.C	ATA.G
GAT.C	ATC.G
CAT.C	ATG.G
ATT.G	ATT.G
TAG.C	CTA.G
GAG.C	CTC.G
CTG.G	CTG.G
CTT.G	CTT.G
TAC.C	GTA.G
GTC.G	GTC.G
GTG.G	GTG.G
GTT.G	GTT.G
TTA.G	TTA.G
TTC.G	TTC.G
TTG.G	TTG.G
TTT.G	TTT.G
